#####################
#P....#.......#....F#
#.##.#.#.###.#.#.##.#
#....#.........#....#
####.###.#.#.###.####
#......#.#.#.#......#
#.####.#.....#.####.#
#........F..........#
#.####.#.....#.####.#
#......#.#.#.#......#
####.###.#.#.###.####
#....#.........#....#
#.##.#.#.###.#.#.##.#
#F....#.......#....F#
#####################