#####################
#P..#.......#......F#
#.#.#.#####.#.####..#
#.#...............#.#
#.#####.###.#####.#.#
#.....#..F..#.......#
#####.#.###.#.#######
#...................#
#######.#.###.#.#####
#.......#.....#.....#
#.#.#####.###.#####.#
#.#...............#.#
#..####.#.#####.#.#.#
#F......#.......#...#
#####################
